ggggggggggggggggggggggggggggggggggggggggggggggggggggggggggggggg
ggggggggggggggggggggggggggggggggggggggggggggggggggggggggggggggg
ggFUUUUUUUUUUUUUUUVUUUUUUUUUUVUUUUUUUUUUUUUUUUUUUUUUUUUUUUUUTgg
ggL...............|..........|..............................Igg
ggL...............|..........|..............................Igg
ggL...............|..........|..............................Igg
ggL...............u..........|.......R................R.....Igg
ggL......R..............R....|..............................Igg
ggL...............n..........|...............[-------D.C----3gg
ggL...............|..........|...............|..............Igg
ggE-----D.C---v---^----D.C---<...............|..............Igg
ggL...........|..............|...............|..............Igg
ggL...........|..............|...............|..............Igg
ggL...........|..............|...............|..............Igg
ggL...........u..............u...............u..............Igg
ggL......R..............R............R................R.....Igg
ggL...........n..............n...............n..............Igg
ggL...........|..............|...............|..............Igg
ggL...........|..............|...............|..............Igg
ggE-----D.C---+--------------+---------------}..............Igg
ggL...........|..............|..............................Igg
ggL...........|..............|..............................Igg
ggL...........|..............>---------------v-------D.C----3gg
ggL...........u..............|...............|..............Igg
ggL......R............R......|...............u..............Igg
ggL...........n..............|..........R.............R.....Igg
ggL...........|..............|...............n..............Igg
ggL...........|..............|...............|..............Igg
ggE-----D.C---^--------------^---------D.C---^-------D.C----3gg
ggL.........................................................Igg
ggL......R..............................R.............R.....Igg
ggL.........................................................Igg
ggL.........................................................Igg
ggKNNNNNNNNNNNNNNNNNNNNNNNNNNNNNNNNNNNNNNNNNNNNNNNNNNNNNNNNNJgg
ggggggggggggggggggggggggggggggggggggggggggggggggggggggggggggggg
ggggggggggggggggggggggggggggggggggggggggggggggggggggggggggggggg
